3000000004
0020000000
0000000000
0000000000
0000000000
0000000000
0000000000
0000000000
0000000000
5000000006
