3000000004
0002000000
0000000000
0000000000
0000000000
0000000000
0000000000
0000000000
0000000000
5000000006
