3000000004
0001000000
0000000000
0000000000
0000000000
0000000000
0000000000
0000000000
0000000000
5000000006
